//MAP CONVERTED BY dmm2tgm.py THIS HEADER COMMENT PREVENTS RECONVERSION, DO NOT REMOVE
"a" = (
/obj/structure/flora/bush/fullgrass/style_random,
/turf/open/misc/grass,
/area/space)
"b" = (
/turf/open/misc/dirt/jungle,
/area/space)
"c" = (
/turf/open/misc/sandy_dirt,
/area/space)
"d" = (
/obj/structure/flora/bush/fullgrass/style_random,
/obj/effect/landmark/ragecage,
/turf/open/misc/grass/jungle/station,
/area/space)
"e" = (
/obj/structure/grille/indestructible/shocked,
/turf/open/floor/plating,
/area/space)
"g" = (
/turf/open/misc/grass/jungle/station,
/area/space)
"q" = (
/obj/effect/spawner/random/engineering/toolbox,
/turf/open/misc/sandy_dirt,
/area/space)
"u" = (
/obj/structure/flora/bush/fullgrass/style_random,
/turf/open/misc/grass/jungle/station,
/area/space)
"v" = (
/obj/effect/landmark/ragecage,
/turf/open/misc/grass/jungle/station,
/area/space)
"w" = (
/obj/item/spear,
/turf/open/misc/dirt/jungle,
/area/space)
"x" = (
/obj/effect/landmark/ragecage/second,
/turf/open/misc/dirt/jungle,
/area/space)
"z" = (
/obj/effect/landmark/ragecage,
/turf/open/misc/dirt/jungle,
/area/space)
"A" = (
/obj/effect/landmark/ragecage/second,
/turf/open/misc/grass,
/area/space)
"C" = (
/obj/structure/flora/bush/jungle/b/style_random,
/turf/open/misc/grass/jungle/station,
/area/space)
"D" = (
/obj/item/clothing/gloves/color/fyellow,
/obj/structure/cable,
/turf/open/floor/plating,
/area/space)
"F" = (
/obj/structure/flora/bush/fullgrass/style_random,
/obj/effect/landmark/ragecage/second,
/turf/open/misc/grass,
/area/space)
"I" = (
/turf/open/misc/grass,
/area/space)
"M" = (
/obj/item/clothing/gloves/cut,
/turf/open/misc/dirt/jungle,
/area/space)
"Q" = (
/obj/item/spear,
/turf/open/misc/grass,
/area/space)
"R" = (
/obj/structure/cable,
/turf/open/floor/plating,
/area/space)
"Y" = (
/obj/effect/spawner/random/engineering/toolbox,
/turf/open/misc/dirt/jungle,
/area/space)

(1,1,1) = {"
e
e
e
e
e
e
e
e
e
e
e
e
"}
(2,1,1) = {"
e
b
v
u
C
M
R
Y
a
F
I
e
"}
(3,1,1) = {"
e
g
u
v
Y
b
R
b
A
Q
a
e
"}
(4,1,1) = {"
e
b
d
b
b
R
D
b
b
F
a
e
"}
(5,1,1) = {"
e
w
b
z
b
R
c
b
x
b
b
e
"}
(6,1,1) = {"
e
b
z
b
b
R
q
c
b
x
b
e
"}
(7,1,1) = {"
e
e
e
e
e
e
e
e
e
e
e
e
"}
